111111111111111111111
100100000000000K00001
1K0100C000000C00KKK01
11110000K0K11KKK000K1
101C000K00000CC000001
1000K0C000000000000C1
100000011010000001111
111C000K00000C0K01111
1P000E001C10010000001
111111111111111111111
