111111111
1PCCKKKK1
1CC000KK1
1K0C00KK1
1K0CC0KK1
1K0C0CCK1
1KKKKCEK1
111111111