111111111111
1E1CCCCCCCC1
10C100K00CC1
10CKCCCC0CC1
10CKCP0C0CC1
10CKCC0C0CC1
10CK000C0CC1
10CKC1C00CC1
100000100CC1
111111111111