11111111111
1E1CCCCCCC1
10C000K00C1
10C0CCCC0C1
10C0CP0C0C1
10C0CC0C0C1
10C0000C0C1
10CCC1C00C1
100000100C1
11111111111